11111111
1C000001
10101101
1P1E1C01
11111111