111111111
1C00X0001
10X0X0X01
1PX00CXE1
111111111